{
  "chunkX": 0,
  "chunkY": 0,
  "surface": [
    [0,4,4,4,0,0,0,0,0,0,4,4,4,4,0,0],
    [0,4,4,4,0,0,0,0,0,0,4,0,0,4,0,0],
    [0,4,4,4,0,0,0,0,0,0,4,4,4,4,0,0],
    [0,4,4,4,0,0,0,0,0,0,4,4,4,4,0,0],
    [0,4,4,4,0,0,0,0,0,0,0,0,0,0,0,0],
    [0,4,4,4,0,0,0,0,0,0,0,0,0,0,0,0],
    [0,4,4,4,0,0,0,0,0,0,0,0,0,0,0,0],
    [0,4,4,4,0,0,0,0,0,0,0,0,0,0,0,0],
    [0,4,4,4,0,0,0,0,0,0,0,0,0,0,0,0],
    [0,4,4,4,0,0,0,0,0,0,0,0,0,0,0,0],
    [0,4,4,4,0,0,0,0,0,0,0,0,0,0,0,0],
    [0,4,4,4,0,0,0,0,0,0,0,0,0,0,0,0],
    [0,4,4,4,0,0,0,0,0,0,0,0,0,0,0,0],
    [0,4,4,4,0,0,0,0,0,0,0,0,0,0,0,0],
    [0,4,4,4,0,0,0,0,0,0,0,0,0,0,0,0],
    [0,4,4,4,0,0,0,0,0,0,0,0,0,0,0,0]
  ],
  "height": [
    [1,0,0,0,1,1,1,1,1,1,0,0,0,0,1,1],
    [1,0,0,0,1,1,1,1,1,1,0,1,1,0,1,1],
    [1,0,0,0,1,1,1,1,1,1,0,0,0,0,1,1],
    [1,0,0,0,1,1,1,1,1,1,0,0,0,0,1,1],
    [1,0,0,0,1,1,1,1,1,1,1,1,1,1,1,1],
    [1,0,0,0,1,1,1,1,1,1,1,1,1,1,1,1],
    [1,0,0,0,1,1,1,1,1,1,1,1,1,1,1,1],
    [1,0,0,0,1,1,1,1,1,1,1,1,1,1,1,1],
    [1,0,0,0,1,1,1,1,1,1,1,1,1,1,1,1],
    [1,0,0,0,1,1,1,1,1,1,1,1,1,1,1,1],
    [1,0,0,0,1,1,1,1,1,1,1,1,1,1,1,1],
    [1,0,0,0,1,1,1,1,1,1,1,1,1,1,1,1],
    [1,0,0,0,1,1,1,1,1,1,1,1,1,1,1,1],
    [1,0,0,0,1,1,1,1,1,1,1,1,1,1,1,1],
    [1,0,0,0,1,1,1,1,1,1,1,1,1,1,1,1],
    [1,0,0,0,1,1,1,1,1,1,1,1,1,1,1,1]
  ],
  "water": [
    [0,3,3,3,0,0,0,0,0,0,4,4,4,4,0,0],
    [0,3,3,3,0,0,0,0,0,0,4,0,0,4,0,0],
    [0,3,3,3,0,0,0,0,0,0,4,4,4,4,0,0],
    [0,3,3,3,0,0,0,0,0,0,4,4,4,4,0,0],
    [0,3,3,3,0,0,0,0,0,0,0,0,0,0,0,0],
    [0,3,3,3,0,0,0,0,0,0,0,0,0,0,0,0],
    [0,3,3,3,0,0,0,0,0,0,0,0,0,0,0,0],
    [0,3,3,3,0,0,0,0,0,0,0,0,0,0,0,0],
    [0,3,3,3,0,0,0,0,0,0,0,0,0,0,0,0],
    [0,3,3,3,0,0,0,0,0,0,0,0,0,0,0,0],
    [0,3,3,3,0,0,0,0,0,0,0,0,0,0,0,0],
    [0,3,3,3,0,0,0,0,0,0,0,0,0,0,0,0],
    [0,3,3,3,0,0,0,0,0,0,0,0,0,0,0,0],
    [0,3,3,3,0,0,0,0,0,0,0,0,0,0,0,0],
    [0,3,3,3,0,0,0,0,0,0,0,0,0,0,0,0],
    [0,3,3,3,0,0,0,0,0,0,0,0,0,0,0,0]
  ],
  "structure": [
    [0,0,0,0,0,0,0,0,0,0,0,0,0,0,0,0],
    [0,0,0,0,0,0,0,0,0,0,0,0,0,0,0,0],
    [0,0,0,0,0,0,0,0,0,0,0,0,0,0,0,0],
    [0,0,0,0,0,0,0,0,0,0,0,0,0,0,0,0],
    [0,0,0,0,0,0,0,0,0,0,0,0,0,0,0,0],
    [0,0,0,0,0,0,0,0,0,0,0,0,0,0,0,0],
    [0,0,0,0,0,0,0,0,0,0,0,0,0,0,0,0],
    [0,0,0,0,0,0,0,0,0,0,0,0,0,0,0,0],
    [0,0,0,0,0,0,0,0,0,0,0,0,0,0,0,0],
    [0,0,0,0,0,0,0,0,0,0,0,0,0,0,0,0],
    [0,0,0,0,0,0,0,0,0,0,0,0,0,0,0,0],
    [0,0,0,0,0,0,0,0,0,0,0,0,0,0,0,0],
    [0,0,0,0,0,0,0,0,0,0,0,0,0,0,0,0],
    [0,0,0,0,0,0,0,0,0,0,0,0,0,0,0,0],
    [0,0,0,0,0,0,0,0,0,0,0,0,0,0,0,0],
    [0,0,0,0,0,0,0,0,0,0,0,0,0,0,0,0]
  ],
  "flags": [
    [1,0,0,0,1,1,1,1,1,1,0,0,0,0,1,1],
    [1,0,0,0,1,1,1,1,1,1,0,1,1,0,1,1],
    [1,0,0,0,1,1,1,1,1,1,0,0,0,0,1,1],
    [1,0,0,0,1,1,1,1,1,1,0,0,0,0,1,1],
    [1,0,0,0,1,1,1,1,1,1,1,1,1,1,1,1],
    [1,0,0,0,1,1,1,1,1,1,1,1,1,1,1,1],
    [1,0,0,0,1,1,1,1,1,1,1,1,1,1,1,1],
    [1,0,0,0,1,1,1,1,1,1,1,1,1,1,1,1],
    [1,0,0,0,1,1,1,1,1,1,1,1,1,1,1,1],
    [1,0,0,0,1,1,1,1,1,1,1,1,1,1,1,1],
    [1,0,0,0,1,1,1,1,1,1,1,1,1,1,1,1],
    [1,0,0,0,1,1,1,1,1,1,1,1,1,1,1,1],
    [1,0,0,0,1,1,1,1,1,1,1,1,1,1,1,1],
    [1,0,0,0,1,1,1,1,1,1,1,1,1,1,1,1],
    [1,0,0,0,1,1,1,1,1,1,1,1,1,1,1,1],
    [1,0,0,0,1,1,1,1,1,1,1,1,1,1,1,1]
  ],
  "variant": [
    [0,0,0,0,0,0,0,0,0,0,0,0,0,0,0,0],
    [0,0,0,0,0,0,0,0,0,0,0,0,0,0,0,0],
    [0,0,0,0,0,0,0,0,0,0,0,0,0,0,0,0],
    [0,0,0,0,0,0,0,0,0,0,0,0,0,0,0,0],
    [0,0,0,0,0,0,0,0,0,0,0,0,0,0,0,0],
    [0,0,0,0,0,0,0,0,0,0,0,0,0,0,0,0],
    [0,0,0,0,0,0,0,0,0,0,0,0,0,0,0,0],
    [0,0,0,0,0,0,0,0,0,0,0,0,0,0,0,0],
    [0,0,0,0,0,0,0,0,0,0,0,0,0,0,0,0],
    [0,0,0,0,0,0,0,0,0,0,0,0,0,0,0,0],
    [0,0,0,0,0,0,0,0,0,0,0,0,0,0,0,0],
    [0,0,0,0,0,0,0,0,0,0,0,0,0,0,0,0],
    [0,0,0,0,0,0,0,0,0,0,0,0,0,0,0,0],
    [0,0,0,0,0,0,0,0,0,0,0,0,0,0,0,0],
    [0,0,0,0,0,0,0,0,0,0,0,0,0,0,0,0],
    [0,0,0,0,0,0,0,0,0,0,0,0,0,0,0,0]
  ]
}
